111111111111111
1100000C10011E1
100V0000C000001
1C00000110CV001
1C0000V000PV001
1C00000000C0001
111111111111111